⬜️⬜️⬜️⬜️⬛️⬛️⬛️⬛️⬛️⬜️⬜️⬜️⬜️⬜️⬜️⬜️⬜️⬜️⬜️⬜️⬜️⬜️⬜️⬜️⬜️⬜️⬜️⬜️⬜️⬜️⬜️
⬜️⬜️⬜️⬜️⬛️⬜️⬜️⬜️⬛️⬜️⬜️⬜️⬜️⬜️⬜️⬜️⬜️⬜️⬜️⬜️⬜️⬜️⬜️⬜️⬜️⬜️⬜️⬜️⬜️⬜️⬜️
⬜️⬜️⬜️⬜️⬛️⬜️⬜️⬜️⬛️⬜️⬜️⬜️⬜️⬜️⬜️⬜️⬜️⬜️⬜️⬜️⬜️⬜️⬜️⬜️⬜️⬜️⬜️⬜️⬜️⬜️⬜️
⬜️⬜️⬜️⬜️⬛️⬜️⬜️⬜️⬛️⬜️⬜️⬜️⬜️⬜️⬜️⬜️⬜️⬜️⬜️⬜️⬜️⬜️⬜️⬜️⬜️⬜️⬜️⬜️⬜️⬜️⬜️
⬜️⬜️⬛️⬛️⬛️⬛️⬛️⬛️⬛️⬜️⬛️⬛️⬛️⬛️⬛️⬛️⬛️⬛️⬛️⬛️⬛️⬛️⬛️⬜️⬜️⬜️⬜️⬜️⬜️⬜️⬜️
⬜️⬜️⬛️⬜️⬛️⬜️⬜️⬜️⬜️⬜️⬛️⬜️⬜️⬜️⬜️⬜️⬜️⬜️⬜️⬜️⬜️⬜️⬛️⬜️⬜️⬜️⬜️⬜️⬜️⬜️⬜️
⬜️⬜️⬛️⬜️⬛️⬜️⬜️⬜️⬜️⬜️⬛️⬜️⬛️⬛️⬛️⬛️⬛️⬛️⬛️⬛️⬛️⬜️⬛️⬜️⬜️⬜️⬜️⬜️⬜️⬜️⬜️
⬜️⬜️⬛️⬜️⬛️⬜️⬜️⬜️⬜️⬜️⬛️⬜️⬛️⬜️⬜️⬜️⬜️⬜️⬜️⬜️⬛️⬜️⬛️⬜️⬜️⬜️⬜️⬜️⬜️⬜️⬜️
⬜️⬜️⬛️⬜️⬛️⬜️⬜️⬜️⬜️⬜️⬛️⬜️⬛️⬜️⬜️⬜️⬜️⬜️⬛️⬛️⬛️⬛️⬛️⬜️⬜️⬜️⬜️⬜️⬜️⬜️⬜️
⬜️⬜️⬛️⬜️⬛️⬜️⬜️⬜️⬜️⬜️⬛️⬜️⬛️⬜️⬜️⬜️⬜️⬜️⬛️⬜️⬛️⬜️⬜️⬜️⬜️⬜️⬜️⬜️⬜️⬜️⬜️
⬜️⬜️⬛️⬜️⬛️⬜️⬜️⬜️⬜️⬜️⬛️⬜️⬛️⬜️⬜️⬜️⬜️⬜️⬛️⬜️⬛️⬜️⬜️⬜️⬜️⬜️⬜️⬜️⬜️⬜️⬜️
⬜️⬜️⬛️⬜️⬛️⬜️⬜️⬜️⬜️⬜️⬛️⬜️⬛️⬜️⬜️⬜️⬜️⬜️⬛️⬜️⬛️⬜️⬜️⬜️⬜️⬜️⬜️⬜️⬜️⬜️⬜️
⬜️⬜️⬛️⬜️⬛️⬛️⬛️⬛️⬛️⬛️⬛️⬛️⬛️⬛️⬛️⬛️⬛️⬜️⬛️⬜️⬛️⬜️⬜️⬜️⬜️⬜️⬜️⬜️⬜️⬜️⬜️
⬜️⬜️⬛️⬜️⬜️⬜️⬜️⬜️⬜️⬜️⬛️⬜️⬛️⬜️⬜️⬜️⬛️⬜️⬛️⬜️⬛️⬜️⬜️⬜️⬜️⬜️⬜️⬜️⬜️⬜️⬜️
⬛️⬛️⬛️⬛️⬛️⬜️⬜️⬜️⬜️⬜️⬛️⬜️⬛️⬜️⬜️⬜️⬛️⬜️⬛️⬜️⬛️⬜️⬜️⬜️⬜️⬜️⬜️⬜️⬜️⬜️⬜️
⬛️⬜️⬛️⬜️⬛️⬜️⬜️⬜️⬜️⬜️⬛️⬜️⬛️⬜️⬜️⬜️⬛️⬜️⬛️⬜️⬛️⬜️⬜️⬜️⬜️⬜️⬜️⬜️⬜️⬜️⬜️
⬛️⬜️⬛️⬛️⬛️⬛️⬛️⬛️⬛️⬛️⬛️⬜️⬛️⬜️⬜️⬜️⬛️⬜️⬛️⬛️⬛️⬛️⬛️⬛️⬛️⬛️⬛️⬛️⬛️⬛️⬛️
⬛️⬜️⬜️⬜️⬛️⬜️⬜️⬜️⬜️⬜️⬜️⬜️⬛️⬜️⬜️⬜️⬛️⬜️⬜️⬜️⬛️⬜️⬜️⬜️⬜️⬜️⬜️⬜️⬜️⬜️⬛️
⬛️⬛️⬛️⬛️⬛️⬛️⬛️⬛️⬛️⬛️⬛️⬛️⬛️⬜️⬛️⬛️⬛️⬛️⬛️⬛️⬛️⬜️⬜️⬜️⬜️⬜️⬜️⬜️⬜️⬜️⬛️
⬜️⬜️⬜️⬜️⬛️⬜️⬜️⬜️⬜️⬜️⬜️⬜️⬜️⬜️⬛️⬜️⬛️⬜️⬜️⬜️⬜️⬜️⬜️⬜️⬜️⬜️⬜️⬜️⬜️⬜️⬛️
⬜️⬜️⬜️⬜️⬛️⬛️⬛️⬛️⬛️⬛️⬛️⬛️⬛️⬛️⬛️⬛️⬛️⬜️⬜️⬜️⬜️⬜️⬜️⬜️⬜️⬜️⬜️⬜️⬜️⬜️⬛️
⬜️⬜️⬜️⬜️⬜️⬜️⬜️⬜️⬜️⬜️⬜️⬜️⬜️⬜️⬛️⬜️⬜️⬜️⬜️⬜️⬜️⬜️⬜️⬜️⬜️⬜️⬜️⬜️⬜️⬜️⬛️
⬜️⬜️⬜️⬜️⬜️⬜️⬜️⬜️⬜️⬜️⬜️⬜️⬜️⬜️⬛️⬜️⬜️⬜️⬜️⬜️⬜️⬜️⬜️⬜️⬜️⬜️⬜️⬜️⬜️⬜️⬛️
⬜️⬜️⬜️⬜️⬜️⬜️⬜️⬜️⬜️⬜️⬜️⬜️⬜️⬜️⬛️⬜️⬜️⬜️⬜️⬜️⬜️⬜️⬜️⬜️⬜️⬜️⬜️⬜️⬜️⬜️⬛️
⬜️⬜️⬜️⬜️⬜️⬜️⬜️⬜️⬜️⬜️⬜️⬜️⬜️⬜️⬛️⬜️⬜️⬜️⬜️⬜️⬜️⬜️⬜️⬜️⬜️⬜️⬜️⬜️⬜️⬜️⬛️
⬜️⬜️⬜️⬜️⬜️⬜️⬜️⬜️⬜️⬜️⬜️⬜️⬜️⬜️⬛️⬜️⬜️⬜️⬜️⬜️⬜️⬜️⬜️⬜️⬜️⬜️⬜️⬜️⬜️⬜️⬛️
⬜️⬜️⬜️⬜️⬜️⬜️⬜️⬜️⬜️⬜️⬜️⬜️⬜️⬜️⬛️⬜️⬜️⬜️⬜️⬜️⬜️⬜️⬜️⬜️⬜️⬜️⬜️⬜️⬜️⬜️⬛️
⬜️⬜️⬜️⬜️⬜️⬜️⬜️⬜️⬜️⬜️⬜️⬜️⬜️⬜️⬛️⬜️⬜️⬜️⬜️⬜️⬜️⬜️⬜️⬜️⬜️⬜️⬜️⬜️⬜️⬜️⬛️
⬜️⬜️⬜️⬜️⬜️⬜️⬜️⬜️⬜️⬜️⬜️⬜️⬜️⬜️⬛️⬜️⬜️⬜️⬜️⬜️⬜️⬜️⬜️⬜️⬜️⬜️⬜️⬜️⬜️⬜️⬛️
⬜️⬜️⬜️⬜️⬜️⬜️⬜️⬜️⬜️⬜️⬜️⬜️⬜️⬜️⬛️⬜️⬜️⬜️⬜️⬜️⬜️⬜️⬜️⬜️⬜️⬜️⬜️⬜️⬜️⬜️⬜️
⬜️⬜️⬜️⬜️⬜️⬜️⬜️⬜️⬜️⬜️⬜️⬜️⬜️⬜️⬛️⬛️⬛️⬛️⬛️⬛️⬛️⬛️⬛️⬛️⬛️⬛️⬛️⬜️⬜️⬜️⬜️
⬜️⬜️⬜️⬜️⬜️⬜️⬜️⬜️⬜️⬜️⬜️⬜️⬜️⬜️⬜️⬜️⬜️⬜️⬜️⬜️⬜️⬜️⬜️⬜️⬜️⬜️⬛️⬜️⬜️⬜️⬜️
⬜️⬜️⬜️⬜️⬜️⬜️⬜️⬜️⬜️⬜️⬜️⬜️⬜️⬜️⬜️⬜️⬜️⬜️⬜️⬜️⬜️⬜️⬜️⬜️⬜️⬜️⬛️⬜️⬜️⬜️⬜️
⬜️⬜️⬜️⬜️⬜️⬜️⬜️⬜️⬜️⬜️⬜️⬜️⬜️⬜️⬜️⬜️⬜️⬜️⬜️⬜️⬜️⬜️⬜️⬜️⬜️⬜️⬛️⬜️⬜️⬜️⬜️
⬜️⬜️⬜️⬜️⬜️⬜️⬜️⬜️⬜️⬜️⬜️⬜️⬜️⬜️⬜️⬜️⬜️⬜️⬜️⬜️⬜️⬜️⬜️⬜️⬜️⬜️⬛️⬜️⬜️⬜️⬜️
⬜️⬜️⬜️⬜️⬜️⬜️⬜️⬜️⬜️⬜️⬜️⬜️⬜️⬜️⬜️⬜️⬜️⬜️⬜️⬜️⬜️⬜️⬜️⬜️⬜️⬜️⬛️⬜️⬜️⬜️⬜️
⬜️⬜️⬜️⬜️⬜️⬜️⬜️⬜️⬜️⬜️⬜️⬜️⬜️⬜️⬜️⬜️⬜️⬜️⬜️⬜️⬜️⬜️⬜️⬜️⬜️⬜️⬛️⬜️⬜️⬜️⬜️
⬜️⬜️⬜️⬜️⬜️⬜️⬜️⬜️⬜️⬜️⬜️⬜️⬜️⬜️⬜️⬜️⬜️⬜️⬜️⬜️⬜️⬜️⬜️⬜️⬜️⬜️⬛️⬜️⬜️⬜️⬜️
⬜️⬜️⬜️⬜️⬜️⬜️⬜️⬜️⬜️⬜️⬜️⬜️⬜️⬜️⬛️⬛️⬛️⬛️⬛️⬛️⬛️⬛️⬛️⬛️⬛️⬛️⬛️⬜️⬜️⬜️⬜️
⬜️⬜️⬜️⬜️⬜️⬜️⬜️⬜️⬜️⬜️⬜️⬜️⬜️⬜️⬛️⬜️⬜️⬜️⬜️⬜️⬜️⬜️⬜️⬜️⬜️⬜️⬜️⬜️⬜️⬜️⬜️
⬜️⬜️⬜️⬜️⬜️⬜️⬜️⬜️⬜️⬜️⬜️⬜️⬜️⬜️⬛️⬜️⬜️⬜️⬜️⬜️⬜️⬜️⬜️⬜️⬜️⬜️⬜️⬜️⬜️⬜️⬜️
⬜️⬜️⬜️⬜️⬜️⬜️⬜️⬜️⬜️⬜️⬜️⬜️⬜️⬜️⬛️⬜️⬜️⬜️⬜️⬜️⬜️⬜️⬜️⬜️⬜️⬜️⬜️⬜️⬜️⬜️⬜️
⬜️⬜️⬜️⬜️⬜️⬜️⬛️⬛️⬛️⬛️⬛️⬛️⬛️⬛️⬛️⬛️⬛️⬛️⬛️⬜️⬜️⬜️⬜️⬜️⬜️⬜️⬜️⬜️⬜️⬜️⬜️
⬜️⬜️⬜️⬜️⬜️⬜️⬛️⬜️⬜️⬜️⬜️⬜️⬜️⬜️⬛️⬜️⬜️⬜️⬛️⬜️⬜️⬜️⬜️⬜️⬜️⬜️⬜️⬜️⬜️⬜️⬜️
⬜️⬜️⬜️⬜️⬜️⬜️⬛️⬜️⬜️⬜️⬜️⬜️⬜️⬜️⬛️⬜️⬜️⬜️⬛️⬜️⬜️⬜️⬜️⬜️⬜️⬜️⬜️⬜️⬜️⬜️⬜️
⬜️⬜️⬜️⬜️⬜️⬜️⬛️⬜️⬜️⬜️⬜️⬜️⬜️⬜️⬛️⬜️⬜️⬜️⬛️⬜️⬜️⬜️⬜️⬜️⬜️⬜️⬜️⬜️⬜️⬜️⬜️
⬜️⬜️⬜️⬜️⬜️⬜️⬛️⬜️⬜️⬜️⬜️⬜️⬜️⬜️⬛️⬜️⬜️⬜️⬛️⬜️⬜️⬜️⬜️⬜️⬜️⬜️⬜️⬜️⬜️⬜️⬜️
⬜️⬜️⬜️⬜️⬜️⬜️⬛️⬜️⬜️⬜️⬜️⬜️⬜️⬜️⬛️⬜️⬜️⬜️⬛️⬜️⬜️⬜️⬜️⬜️⬜️⬜️⬜️⬜️⬜️⬜️⬜️
⬜️⬜️⬜️⬜️⬜️⬜️⬛️⬜️⬜️⬜️⬜️⬜️⬜️⬜️⬛️⬜️⬜️⬜️🤖⬜️⬜️⬜️⬜️⬜️⬜️⬜️⬜️⬜️⬜️⬜️⬜️
⬜️⬜️⬜️⬜️⬜️⬜️⬛️⬜️⬜️⬜️⬜️⬜️⬜️⬜️⬛️⬜️⬜️⬜️⬜️⬜️⬜️⬜️⬜️⬜️⬜️⬜️⬜️⬜️⬜️⬜️⬜️
⬜️⬜️⬜️⬜️⬜️⬜️⬛️⬛️⬛️⬛️⬛️⬛️⬛️⬛️⬛️⬜️⬜️⬜️⬜️⬜️⬜️⬜️⬜️⬜️⬜️⬜️⬜️⬜️⬜️⬜️⬜️